111111111
1P0000001
111101101
1C0000C01
1000000E1
111111111
