1111111
1P00001
1C01111
1000001
1E00C01
1111111
