1111111111111111111111111111111
1P00000000000000000000000000001
111111111111C0000C00011111111C1
1000000000000000000000000000001
1C11111111111111111111111111111
1000000000000000000000000000011
11111111111110111111111111111C1
1E00C00000000000000000000000011
1111111111111111111111111111111
