1111111111
1E0000C0C1
10C1101111
10000000C1
1100000001
1C00000001
11000P0011
1111111111
