11111111111
1E00000C001
10000C00101
10000100001
10000000001
1000P111111
11111111111
